*****************************************
*   *       *           *       *      E*
*   *   *   *   *****   *    ****   *   *
*       *           *   *           *   *
*************   *   *   *    ************
*               *   *        *          *
*   *************   *****************   *
*   *           *   *           *   *   *
*   *****   *   *   *   ****    *   *   *
*       *   *   *       *       *   *   *
*****   *****   *********   *****   *   *
*   *           *           *   *       *
*   *************   *********   *****   *
*   *           *       *               *
*   *   *****   ****    *   *   *********
*       *   *   *           *       *   *
*********   *   ****    ********    *   *
*       *               *      *    *   *
*   *   *****   ************   *    *   *
*S  *                          *        *
*****************************************

