**************************
*         *         *  E * 
*         *         *    *
*    *    *    *    *    *
*    *    *    *    *    *
*    *    *    *    *    *
*    *    *    *    *    *
*    *    *    *    *    *
*    *    *    *    *    *
*    *         *         *
* S  *         *         *
**************************

